{
  "name": "cre8ors-map",
  "areas": [
    {
      "id": "469f9800-c45a-483f-b13e-bd24f3fb79f1",
      "title": "color_red",
      "shape": "poly",
      "name": "1",
      "fillColor": "#ffffff00",
      "strokeColor": "#ffffff00",
      "coords": [
        0, 0, 250, 0, 270, 30, 200, 100, 230, 110, 230, 150, 260, 160, 340, 150, 330, 130, 355, 110,
        380, 150, 440, 140, 440, 110, 330, 0, 540, 0, 550, 10, 500, 60, 520, 80, 540, 80, 560, 40,
        600, 40, 630, 50, 655, 80, 650, 100, 640, 110, 630, 120, 670, 140, 680, 110, 780, 10, 800,
        0, 840, 0, 840, 10, 820, 15, 820, 40, 840, 60, 840, 280, 620, 550, 660, 570, 840, 350, 840,
        570, 780, 630, 840, 680, 840, 880, 820, 880, 640, 700, 660, 690, 680, 670, 580, 560, 520,
        580, 480, 560, 460, 580, 490, 590, 510, 580, 510, 640, 490, 660, 460, 670, 450, 660, 430,
        680, 590, 880, 400, 880, 300, 760, 280, 780, 270, 760, 330, 680, 300, 620, 280, 600, 260,
        590, 240, 570, 200, 480, 160, 510, 30, 630, 0, 600
      ]
    }
  ]
}
